5,3,4,0,7,8,9,1,2
6,7,2,1,9,5,3,4,8
1,9,8,3,4,0,5,6,0
0,5,9,7,6,0,4,2,3
4,0,6,8,5,3,7,9,1
7,1,3,9,2,0,8,5,6
9,6,1,0,3,7,2,0,4
2,8,7,4,1,9,6,3,5
3,0,5,2,8,6,1,7,9
25,55,63,67,35,30,81,28,41,03