0,3,4,0,7,8,9,0,2
6,7,2,1,9,5,3,4,8
1,9,0,3,4,2,5,0,0
0,5,9,7,6,1,4,2,3
4,2,6,8,5,3,7,9,1
7,1,3,9,2,0,8,5,6
9,6,1,5,0,7,2,8,4
2,8,7,4,1,9,6,3,0
3,4,5,2,8,6,1,7,9
30,78,22,64,28,27,00,55,03,07