0,3,4,6,7,8,9,1,2
6,7,2,0,9,5,3,4,8
1,9,8,3,4,2,5,6,7
8,5,9,7,6,1,4,2,3
4,2,6,0,0,3,0,0,0
7,1,3,9,2,4,8,5,6
0,6,1,5,3,7,2,8,4
2,0,7,4,1,9,0,3,5
3,4,5,2,8,6,1,7,9
13,48,71,76,00,44,60,47,46,43