0,3,4,0,7,8,0,1,2
0,0,2,1,0,5,0,4,0
1,9,8,3,4,0,0,6,7
8,5,9,7,6,1,4,2,3
0,2,0,8,0,3,7,9,1
7,0,0,9,2,4,8,0,0
9,6,0,5,0,7,2,0,4
2,8,7,4,1,9,6,0,5
3,4,0,2,8,0,0,0,9
86,14,18,57,44,64,11,82,06,77,62,58,26,42,67,16,52,40,85,87,10,03,25,00,51