0,3,0,0,7,8,9,0,0
0,7,0,1,9,0,3,4,8
1,9,8,3,4,2,0,6,0
0,5,9,7,6,1,4,0,3
4,2,6,8,0,3,0,9,0
0,1,3,9,0,0,0,5,0
9,6,1,5,0,7,2,8,4
0,0,7,4,1,9,6,3,5
3,0,5,2,8,0,1,7,9
48,70,81,50,64,08,85,71,30,54,15,26,46,37,55,07,56,10,03,00,28,44,12,02,58