5,3,0,6,7,0,9,0,2
6,7,2,1,0,5,0,4,8
1,0,0,3,4,2,0,6,7
8,0,9,7,6,0,4,2,3
0,0,6,8,0,3,0,9,0
7,1,0,9,0,0,0,5,6
9,6,0,5,3,7,2,8,0
2,8,0,4,1,9,6,0,5
3,0,5,2,8,6,1,7,0
31,62,40,54,88,05,26,48,41,68,81,77,52,14,72,16,46,21,55,56,02,07,44,22,35