5,3,4,6,7,0,9,1,2
0,7,0,1,0,0,0,4,8
1,9,0,0,4,2,0,0,0
8,5,9,7,0,1,4,2,3
0,2,6,0,5,0,7,9,1
0,1,3,9,2,4,8,0,6
0,6,1,0,3,0,2,0,4
2,8,7,4,1,9,0,3,0
3,4,5,0,8,6,1,7,0
83,12,26,63,15,28,34,67,78,43,40,14,76,22,57,05,27,88,65,50,60,23,45,10,16