5,3,0,6,7,8,9,1,2
0,7,2,1,0,0,0,4,8
1,9,8,3,0,0,0,0,0
0,5,0,7,6,0,0,2,0
4,0,6,8,5,3,7,9,1
7,1,3,9,0,4,8,5,6
9,6,1,5,3,0,2,0,0
2,0,7,4,0,9,6,3,5
0,0,5,2,8,6,0,7,9
68,25,67,74,10,65,26,32,86,54,15,16,24,35,02,28,38,41,71,81,30,27,36,80,14