0,3,0,0,7,8,0,1,2
0,7,2,1,9,5,3,0,8
1,9,8,3,0,2,5,6,7
8,5,9,7,0,0,4,0,0
4,0,0,8,0,3,7,9,0
7,1,0,9,2,4,0,5,6
0,6,1,5,0,7,2,8,4
2,8,7,4,0,0,6,0,5
3,0,5,0,8,6,0,7,9
24,17,00,10,34,83,42,48,44,86,74,38,56,03,06,35,60,41,64,02,52,81,75,77,37