5,3,4,6,0,8,9,1,0
6,7,2,1,0,5,0,0,8
0,0,0,3,4,2,0,6,0
8,5,9,7,6,1,4,2,3
4,0,6,8,0,3,7,9,1
0,0,3,9,2,0,8,5,6
9,6,1,5,0,7,2,0,4
2,0,0,0,1,0,6,3,5
3,0,0,2,0,6,1,0,9
16,72,41,51,14,17,44,26,22,84,28,04,64,08,87,21,67,50,81,73,75,55,82,20,71