0,0,4,6,7,8,9,0,0
0,7,2,1,9,5,3,4,8
1,0,8,0,4,2,0,6,7
8,5,0,7,6,1,4,2,3
0,2,6,0,5,3,7,9,1
7,1,3,9,0,4,0,5,0
9,6,1,0,0,0,2,8,4
2,8,7,0,1,9,6,0,5
3,4,0,2,8,6,1,7,9
01,32,07,82,26,64,56,63,40,77,23,08,65,43,10,58,54,00,73,21