5,3,4,6,7,8,9,1,2
6,7,2,0,9,5,3,0,8
1,9,8,3,4,2,5,0,7
8,5,9,7,6,0,0,2,3
4,2,6,8,5,3,7,9,1
7,1,3,0,2,4,8,5,6
9,6,1,1,3,7,2,8,4
2,8,0,4,0,9,6,3,5
3,4,5,2,8,0,1,7,9
13,17,27,35,36,53,63,72,74,85